56
vomit	呕吐
removal	除去、移动
coral	珊瑚
partial 部分的
slipper	拖鞋
thrift	节俭
forego	放弃；居先；在……之前
disgrace	丢脸；失宠；玷污
enslave	奴役
masculine	男子气的；男性的
envisage	想象；展望
clutch	抓紧；离合器
impetus	推动力；促进
cognitive	认知的
confidential	机密的；受信任的
rash	轻率的；皮疹
momentum	动力
articulate	明确表达；善于表达的
ignite	点燃
fling	扔；风流的事
methane	沼气
veto	否决
sovereign	君主；元首；独立的
obedient	顺从
treaty	条约
desolate	荒无人烟的；使荒凉
grin	咧嘴笑
obsolete	过时的
shed	脱落
resort	求助；度假胜地；
currency	货币；通行
adore	热爱，爱慕
handcuff	手铐
acquit	无罪释放
unrest	动乱	
dismantling	拆卸
tremedous	震耳欲聋
integrity	正直
imminent	迫在眉睫
minority	少数民族

57
tape	磁带
mistrial	无效审判
zealous	热情的；热烈的
attorney	律师（代人出庭者）
baltimore	巴尔的摩
divorce	离婚的男子；离婚；脱离
jeopardy	危险
hindsight	事后聪明；事后的领悟
indecent	下流的；不合时宜的
racism	种族歧视
morale	士气
ethic	伦理道德；行为准则	
resonate	产生共鸣；回荡；起回声
brutal	残暴的；冷酷的；直截了当的；野蛮的
yoke	上枷锁；奴役；轭
amplify	放大
embolden	使加强勇气；使文本变粗体

513
fusion	融合；熔接；结合；核聚变；
buoyancy	浮力；愉快的心情；(经济的)繁荣

518
conventional	依照惯例的；遵循习俗的；墨守成规的；普通平凡的
dissipated	放荡的；耽于享乐的；(使)消散，消失；驱散
spike	有尖刺的；带钉的；用尖物刺入(或扎破)；在…中偷偷掺入(烈酒、毒药或毒品)；拒绝发表；阻止…传播；阻挠
resevoir	水库

520
arbitrage	桃李；套汇
polyhedral	多面的；多面体的
gust	阵风；突然一阵

521
spiral	螺旋；旋球

524
circumvent
adiabatic

525
throttle 